__#####
_##   ##
##  *  ##
#  *$*  #
# #. .#@#
#  *$*  #
##  *  ##
_##   ##
__#####